09 05 05 05 05 05 05 05 05 10 13 13 09 05 05 05 05 05 05 05 05 05 05 05 05 05 05 05 05 05 05 10
08 00 00 00 00 00 00 00 00 06 13 13 08 00 00 00 00 00 00 00 00 00 00 00 00 00 00 00 00 00 00 06
08 00 00 00 00 00 00 00 00 06 13 13 08 00 00 00 00 00 00 00 00 00 00 00 00 00 00 00 00 00 00 06
08 00 00 00 00 00 00 00 00 06 13 13 08 00 00 00 00 00 00 00 00 02 07 07 07 07 01 00 00 00 00 06
08 00 00 00 00 00 00 00 00 06 13 13 08 00 00 00 00 00 00 00 00 06 13 13 13 13 08 00 00 00 00 06
08 00 00 00 00 00 00 00 00 03 05 05 04 00 00 00 00 00 00 00 00 06 13 13 13 13 08 00 00 00 00 06
08 00 00 00 00 00 00 00 00 00 00 00 00 00 00 00 00 00 00 00 00 03 05 05 05 10 08 00 00 00 00 06
08 00 00 00 00 00 00 00 00 00 00 00 00 00 00 00 00 00 00 00 00 00 00 00 00 06 08 00 00 00 00 06
08 00 00 00 00 00 00 00 00 00 00 00 00 00 00 00 00 00 02 07 01 00 00 00 00 03 04 00 00 00 00 06
08 00 00 00 00 02 01 00 00 00 00 00 00 00 00 00 00 00 06 13 08 00 00 00 00 00 00 00 00 00 00 06
08 00 00 00 00 03 04 00 00 00 00 00 00 00 00 00 00 00 03 05 04 00 00 00 00 00 00 00 00 00 00 06
08 00 02 01 00 00 00 00 00 00 00 00 00 00 00 00 00 00 00 00 00 00 00 00 00 00 00 00 00 00 00 06
08 00 03 04 02 01 00 00 00 00 00 00 00 00 00 00 00 00 00 00 00 00 00 00 00 00 00 00 00 00 00 06
08 00 00 00 03 04 00 00 00 00 00 00 00 00 00 00 00 00 00 00 00 00 00 00 00 00 00 00 00 00 00 06
08 00 00 00 00 00 00 02 07 07 01 00 00 00 00 00 00 00 00 00 00 00 00 00 00 00 00 00 00 00 00 06
12 07 07 07 07 07 07 11 13 13 12 07 07 07 07 07 07 07 07 07 07 07 07 07 07 07 07 07 07 07 07 11
|
1 25 40
2 400 500
1 200 200
3 650 50